"filename", "language", "Markdown", "Python", "comment", "blank", "total"
"c:\Users\Misah\OneDrive\Plocha\soubor\PV-Game\Client\__init__.py", "Python", 0, 23, 0, 7, 30
"c:\Users\Misah\OneDrive\Plocha\soubor\PV-Game\README.md", "Markdown", 33, 0, 0, 15, 48
"c:\Users\Misah\OneDrive\Plocha\soubor\PV-Game\Server\Database\Actions\Authentication.py", "Python", 0, 1, 0, 0, 1
"c:\Users\Misah\OneDrive\Plocha\soubor\PV-Game\Server\Database\Actions\Set_status.py", "Python", 0, 1, 0, 0, 1
"c:\Users\Misah\OneDrive\Plocha\soubor\PV-Game\Server\Database\Database.py", "Python", 0, 1, 0, 0, 1
"c:\Users\Misah\OneDrive\Plocha\soubor\PV-Game\Server\Interfaces\First_view.py", "Python", 0, 1, 1, 0, 2
"c:\Users\Misah\OneDrive\Plocha\soubor\PV-Game\Server\Interfaces\Load_user.py", "Python", 0, -1, 0, 0, -1
"c:\Users\Misah\OneDrive\Plocha\soubor\PV-Game\Server\Interfaces\Profil\Profile.py", "Python", 0, 1, 0, 0, 1
"c:\Users\Misah\OneDrive\Plocha\soubor\PV-Game\Server\Others\Connection.py", "Python", 0, 1, 0, 0, 1
"c:\Users\Misah\OneDrive\Plocha\soubor\PV-Game\Server\README.md", "Markdown", -26, 0, 0, -7, -33
"c:\Users\Misah\OneDrive\Plocha\soubor\PV-Game\Server\__init__.py", "Python", 0, 3, 0, 0, 3
"Total", "-", 7, 31, 1, 15, 54