"filename", "language", "Python", "Markdown", "JSON", "comment", "blank", "total"
"c:\Users\Misah\OneDrive\Plocha\soubor\PV-Game\Client\__init__.py", "Python", 61, 0, 0, 1, 5, 67
"c:\Users\Misah\OneDrive\Plocha\soubor\PV-Game\Client\lib\hashing.py", "Python", 5, 0, 0, 0, 1, 6
"c:\Users\Misah\OneDrive\Plocha\soubor\PV-Game\Client\new.py", "Python", 80, 0, 0, 1, 7, 88
"c:\Users\Misah\OneDrive\Plocha\soubor\PV-Game\Server\Database\Actions\Authentication.py", "Python", 31, 0, 0, 0, 4, 35
"c:\Users\Misah\OneDrive\Plocha\soubor\PV-Game\Server\Database\Actions\Get_user_informations.py", "Python", 24, 0, 0, 2, 3, 29
"c:\Users\Misah\OneDrive\Plocha\soubor\PV-Game\Server\Database\Actions\Quests.py", "Python", 10, 0, 0, 4, 1, 15
"c:\Users\Misah\OneDrive\Plocha\soubor\PV-Game\Server\Database\Actions\Registration.py", "Python", 35, 0, 0, 0, 5, 40
"c:\Users\Misah\OneDrive\Plocha\soubor\PV-Game\Server\Database\Actions\Set_quests.py", "Python", 8, 0, 0, 1, 1, 10
"c:\Users\Misah\OneDrive\Plocha\soubor\PV-Game\Server\Database\Actions\Set_status.py", "Python", 29, 0, 0, 0, 4, 33
"c:\Users\Misah\OneDrive\Plocha\soubor\PV-Game\Server\Database\Database.py", "Python", 18, 0, 0, 2, 3, 23
"c:\Users\Misah\OneDrive\Plocha\soubor\PV-Game\Server\Enums\Next_message.py", "Python", 6, 0, 0, 3, 2, 11
"c:\Users\Misah\OneDrive\Plocha\soubor\PV-Game\Server\Gameobjects\Building.py", "Python", 66, 0, 0, 0, 15, 81
"c:\Users\Misah\OneDrive\Plocha\soubor\PV-Game\Server\Gameobjects\Map\Capital_city\Capital_city.py", "Python", 57, 0, 0, 3, 10, 70
"c:\Users\Misah\OneDrive\Plocha\soubor\PV-Game\Server\Gameobjects\Map\Capital_city\Capital_city_tawern.py", "Python", 15, 0, 0, 0, 5, 20
"c:\Users\Misah\OneDrive\Plocha\soubor\PV-Game\Server\Gameobjects\Map\Forest_of_life\Forest_of_life.py", "Python", 25, 0, 0, 0, 3, 28
"c:\Users\Misah\OneDrive\Plocha\soubor\PV-Game\Server\Gameobjects\Map\Gem_town\Gem_town.py", "Python", 19, 0, 0, 0, 2, 21
"c:\Users\Misah\OneDrive\Plocha\soubor\PV-Game\Server\Gameobjects\Map\Place.py", "Python", 132, 0, 0, 0, 28, 160
"c:\Users\Misah\OneDrive\Plocha\soubor\PV-Game\Server\Gameobjects\Map\Route1\Route1.py", "Python", 21, 0, 0, 0, 3, 24
"c:\Users\Misah\OneDrive\Plocha\soubor\PV-Game\Server\Gameobjects\Map\Route2\Route2.py", "Python", 20, 0, 0, 0, 2, 22
"c:\Users\Misah\OneDrive\Plocha\soubor\PV-Game\Server\Gameobjects\NPC.py", "Python", 2, 0, 0, 0, 0, 2
"c:\Users\Misah\OneDrive\Plocha\soubor\PV-Game\Server\Gameobjects\Player.py", "Python", 5, 0, 0, 0, 2, 7
"c:\Users\Misah\OneDrive\Plocha\soubor\PV-Game\Server\Interfaces\CMD_level.py", "Python", 28, 0, 0, 0, 9, 37
"c:\Users\Misah\OneDrive\Plocha\soubor\PV-Game\Server\Interfaces\First_view.py", "Python", 85, 0, 0, 24, 19, 128
"c:\Users\Misah\OneDrive\Plocha\soubor\PV-Game\Server\Interfaces\Inventory.py", "Python", 13, 0, 0, 0, 6, 19
"c:\Users\Misah\OneDrive\Plocha\soubor\PV-Game\Server\Interfaces\Load_user.py", "Python", 32, 0, 0, 0, 2, 34
"c:\Users\Misah\OneDrive\Plocha\soubor\PV-Game\Server\Interfaces\Profil\Profile.py", "Python", 46, 0, 0, 0, 10, 56
"c:\Users\Misah\OneDrive\Plocha\soubor\PV-Game\Server\Interfaces\Register_view.py", "Python", 164, 0, 0, 0, 27, 191
"c:\Users\Misah\OneDrive\Plocha\soubor\PV-Game\Server\Others\Connection.py", "Python", 42, 0, 0, 46, 8, 96
"c:\Users\Misah\OneDrive\Plocha\soubor\PV-Game\Server\Others\Crossing.py", "Python", 16, 0, 0, 0, 5, 21
"c:\Users\Misah\OneDrive\Plocha\soubor\PV-Game\Server\Others\Help_methods.py", "Python", 8, 0, 0, 16, 1, 25
"c:\Users\Misah\OneDrive\Plocha\soubor\PV-Game\Server\README.md", "Markdown", 0, 26, 0, 0, 7, 33
"c:\Users\Misah\OneDrive\Plocha\soubor\PV-Game\Server\__init__.py", "Python", 55, 0, 0, 12, 11, 78
"c:\Users\Misah\OneDrive\Plocha\soubor\PV-Game\Server\database.json", "JSON", 0, 0, 5, 0, 0, 5
"c:\Users\Misah\OneDrive\Plocha\soubor\PV-Game\Server\lib\ICommand.py", "Python", 5, 0, 0, 0, 1, 6
"Total", "-", 1163, 26, 5, 115, 212, 1521