"filename", "language", "Markdown", "SQL", "JSON", "Python", "comment", "blank", "total"
"c:\Users\Misah\OneDrive\Plocha\soubor\PV-Game\Client\__init__.py", "Python", 0, 0, 0, 119, 1, 14, 134
"c:\Users\Misah\OneDrive\Plocha\soubor\PV-Game\Client\konfig\client.json", "JSON", 0, 0, 6, 0, 0, 0, 6
"c:\Users\Misah\OneDrive\Plocha\soubor\PV-Game\Client\lib\hashing.py", "Python", 0, 0, 0, 5, 0, 1, 6
"c:\Users\Misah\OneDrive\Plocha\soubor\PV-Game\README.md", "Markdown", 79, 0, 0, 0, 0, 22, 101
"c:\Users\Misah\OneDrive\Plocha\soubor\PV-Game\Server\Database\Actions\Authentication.py", "Python", 0, 0, 0, 32, 47, 4, 83
"c:\Users\Misah\OneDrive\Plocha\soubor\PV-Game\Server\Database\Actions\Get_user_informations.py", "Python", 0, 0, 0, 17, 32, 2, 51
"c:\Users\Misah\OneDrive\Plocha\soubor\PV-Game\Server\Database\Actions\Inventory_db.py", "Python", 0, 0, 0, 49, 115, 7, 171
"c:\Users\Misah\OneDrive\Plocha\soubor\PV-Game\Server\Database\Actions\Load_player.py", "Python", 0, 0, 0, 24, 52, 3, 79
"c:\Users\Misah\OneDrive\Plocha\soubor\PV-Game\Server\Database\Actions\Quests.py", "Python", 0, 0, 0, 10, 19, 1, 30
"c:\Users\Misah\OneDrive\Plocha\soubor\PV-Game\Server\Database\Actions\Registration.py", "Python", 0, 0, 0, 30, 61, 4, 95
"c:\Users\Misah\OneDrive\Plocha\soubor\PV-Game\Server\Database\Actions\Set_quests.py", "Python", 0, 0, 0, 8, 15, 1, 24
"c:\Users\Misah\OneDrive\Plocha\soubor\PV-Game\Server\Database\Actions\Set_status.py", "Python", 0, 0, 0, 30, 62, 4, 96
"c:\Users\Misah\OneDrive\Plocha\soubor\PV-Game\Server\Database\Database.py", "Python", 0, 0, 0, 11, 8, 2, 21
"c:\Users\Misah\OneDrive\Plocha\soubor\PV-Game\Server\Enums\Next_message.py", "Python", 0, 0, 0, 4, 3, 1, 8
"c:\Users\Misah\OneDrive\Plocha\soubor\PV-Game\Server\Gameobjects\Building.py", "Python", 0, 0, 0, 111, 58, 26, 195
"c:\Users\Misah\OneDrive\Plocha\soubor\PV-Game\Server\Gameobjects\Item.py", "Python", 0, 0, 0, 14, 32, 4, 50
"c:\Users\Misah\OneDrive\Plocha\soubor\PV-Game\Server\Gameobjects\Map\Capital_city\Capital_city.py", "Python", 0, 0, 0, 57, 3, 10, 70
"c:\Users\Misah\OneDrive\Plocha\soubor\PV-Game\Server\Gameobjects\Map\Capital_city\Capital_city_tawern.py", "Python", 0, 0, 0, 18, 0, 4, 22
"c:\Users\Misah\OneDrive\Plocha\soubor\PV-Game\Server\Gameobjects\Map\Forest\Forest.py", "Python", 0, 0, 0, 29, 0, 3, 32
"c:\Users\Misah\OneDrive\Plocha\soubor\PV-Game\Server\Gameobjects\Map\Gem_town\Gem_town.py", "Python", 0, 0, 0, 19, 0, 2, 21
"c:\Users\Misah\OneDrive\Plocha\soubor\PV-Game\Server\Gameobjects\Map\Place.py", "Python", 0, 0, 0, 145, 0, 31, 176
"c:\Users\Misah\OneDrive\Plocha\soubor\PV-Game\Server\Gameobjects\Map\Route1\Route1.py", "Python", 0, 0, 0, 21, 0, 3, 24
"c:\Users\Misah\OneDrive\Plocha\soubor\PV-Game\Server\Gameobjects\Map\Route2\Route2.py", "Python", 0, 0, 0, 20, 0, 2, 22
"c:\Users\Misah\OneDrive\Plocha\soubor\PV-Game\Server\Gameobjects\NPC.py", "Python", 0, 0, 0, 10, 14, 2, 26
"c:\Users\Misah\OneDrive\Plocha\soubor\PV-Game\Server\Gameobjects\NPCs\Bartender.py", "Python", 0, 0, 0, 84, 0, 12, 96
"c:\Users\Misah\OneDrive\Plocha\soubor\PV-Game\Server\Gameobjects\Player.py", "Python", 0, 0, 0, 103, 95, 11, 209
"c:\Users\Misah\OneDrive\Plocha\soubor\PV-Game\Server\Interfaces\CMD_level.py", "Python", 0, 0, 0, 29, 26, 9, 64
"c:\Users\Misah\OneDrive\Plocha\soubor\PV-Game\Server\Interfaces\First_view.py", "Python", 0, 0, 0, 87, 57, 19, 163
"c:\Users\Misah\OneDrive\Plocha\soubor\PV-Game\Server\Interfaces\Inventory_level.py", "Python", 0, 0, 0, 243, 74, 28, 345
"c:\Users\Misah\OneDrive\Plocha\soubor\PV-Game\Server\Interfaces\Load_user.py", "Python", 0, 0, 0, 31, 11, 2, 44
"c:\Users\Misah\OneDrive\Plocha\soubor\PV-Game\Server\Interfaces\Profil\Profile.py", "Python", 0, 0, 0, 116, 52, 20, 188
"c:\Users\Misah\OneDrive\Plocha\soubor\PV-Game\Server\Interfaces\Register_view.py", "Python", 0, 0, 0, 166, 55, 27, 248
"c:\Users\Misah\OneDrive\Plocha\soubor\PV-Game\Server\NPC_battle\Battle_NPC.py", "Python", 0, 0, 0, 6, 0, 1, 7
"c:\Users\Misah\OneDrive\Plocha\soubor\PV-Game\Server\NPC_battle\NPC_battle.py", "Python", 0, 0, 0, 89, 32, 16, 137
"c:\Users\Misah\OneDrive\Plocha\soubor\PV-Game\Server\Others\Connection.py", "Python", 0, 0, 0, 50, 42, 9, 101
"c:\Users\Misah\OneDrive\Plocha\soubor\PV-Game\Server\Others\Crossing.py", "Python", 0, 0, 0, 16, 40, 5, 61
"c:\Users\Misah\OneDrive\Plocha\soubor\PV-Game\Server\Others\Help_methods.py", "Python", 0, 0, 0, 8, 27, 1, 36
"c:\Users\Misah\OneDrive\Plocha\soubor\PV-Game\Server\__init__.py", "Python", 0, 0, 0, 63, 12, 10, 85
"c:\Users\Misah\OneDrive\Plocha\soubor\PV-Game\Server\database.json", "JSON", 0, 0, 5, 0, 0, 0, 5
"c:\Users\Misah\OneDrive\Plocha\soubor\PV-Game\Server\lib\ICommand.py", "Python", 0, 0, 0, 5, 11, 1, 17
"c:\Users\Misah\OneDrive\Plocha\soubor\PV-Game\Server\server.json", "JSON", 0, 0, 5, 0, 0, 0, 5
"c:\Users\Misah\OneDrive\Plocha\soubor\PV-Game\mystic_jewels.session.sql", "SQL", 0, 1, 0, 0, 0, 0, 1
"Total", "-", 79, 1, 16, 1879, 1056, 324, 3355