"filename", "language", "Python", "Markdown", "JSON", "comment", "blank", "total"
"c:\Users\Misah\OneDrive\Plocha\soubor\PV-Game\Client\__init__.py", "Python", 11, 0, 0, 0, 1, 12
"c:\Users\Misah\OneDrive\Plocha\soubor\PV-Game\Client\konfig\client.json", "JSON", 0, 0, 1, 0, 0, 1
"c:\Users\Misah\OneDrive\Plocha\soubor\PV-Game\README.md", "Markdown", 0, 17, 0, 0, 1, 18
"c:\Users\Misah\OneDrive\Plocha\soubor\PV-Game\Server\Database\Actions\Load_player.py", "Python", 10, 0, 0, 1, 1, 12
"c:\Users\Misah\OneDrive\Plocha\soubor\PV-Game\Server\Database\Database.py", "Python", -8, 0, 0, -2, 0, -10
"c:\Users\Misah\OneDrive\Plocha\soubor\PV-Game\Server\Gameobjects\Item.py", "Python", 3, 0, 0, 0, 1, 4
"c:\Users\Misah\OneDrive\Plocha\soubor\PV-Game\Server\Gameobjects\Player.py", "Python", 20, 0, 0, 0, 3, 23
"c:\Users\Misah\OneDrive\Plocha\soubor\PV-Game\Server\Interfaces\First_view.py", "Python", 1, 0, 0, 0, 0, 1
"c:\Users\Misah\OneDrive\Plocha\soubor\PV-Game\Server\Others\Connection.py", "Python", 2, 0, 0, 0, 0, 2
"c:\Users\Misah\OneDrive\Plocha\soubor\PV-Game\Server\__init__.py", "Python", 2, 0, 0, 0, 0, 2
"Total", "-", 41, 17, 1, -1, 7, 65