"filename", "language", "Python", "SQL", "Markdown", "JSON", "comment", "blank", "total"
"c:\Users\Misah\OneDrive\Plocha\soubor\PV-Game\Client\__init__.py", "Python", 119, 0, 0, 0, 1, 14, 134
"c:\Users\Misah\OneDrive\Plocha\soubor\PV-Game\Client\konfig\client.json", "JSON", 0, 0, 0, 6, 0, 0, 6
"c:\Users\Misah\OneDrive\Plocha\soubor\PV-Game\Client\lib\hashing.py", "Python", 5, 0, 0, 0, 0, 1, 6
"c:\Users\Misah\OneDrive\Plocha\soubor\PV-Game\README.md", "Markdown", 0, 0, 79, 0, 0, 22, 101
"c:\Users\Misah\OneDrive\Plocha\soubor\PV-Game\Server\Database\Actions\Authentication.py", "Python", 32, 0, 0, 0, 47, 4, 83
"c:\Users\Misah\OneDrive\Plocha\soubor\PV-Game\Server\Database\Actions\Get_user_informations.py", "Python", 17, 0, 0, 0, 32, 2, 51
"c:\Users\Misah\OneDrive\Plocha\soubor\PV-Game\Server\Database\Actions\Inventory_db.py", "Python", 49, 0, 0, 0, 115, 7, 171
"c:\Users\Misah\OneDrive\Plocha\soubor\PV-Game\Server\Database\Actions\Load_player.py", "Python", 24, 0, 0, 0, 52, 3, 79
"c:\Users\Misah\OneDrive\Plocha\soubor\PV-Game\Server\Database\Actions\Quests.py", "Python", 10, 0, 0, 0, 19, 1, 30
"c:\Users\Misah\OneDrive\Plocha\soubor\PV-Game\Server\Database\Actions\Registration.py", "Python", 30, 0, 0, 0, 61, 4, 95
"c:\Users\Misah\OneDrive\Plocha\soubor\PV-Game\Server\Database\Actions\Set_quests.py", "Python", 8, 0, 0, 0, 15, 1, 24
"c:\Users\Misah\OneDrive\Plocha\soubor\PV-Game\Server\Database\Actions\Set_status.py", "Python", 30, 0, 0, 0, 62, 4, 96
"c:\Users\Misah\OneDrive\Plocha\soubor\PV-Game\Server\Database\Database.py", "Python", 11, 0, 0, 0, 8, 2, 21
"c:\Users\Misah\OneDrive\Plocha\soubor\PV-Game\Server\Enums\Next_message.py", "Python", 4, 0, 0, 0, 3, 1, 8
"c:\Users\Misah\OneDrive\Plocha\soubor\PV-Game\Server\Gameobjects\Building.py", "Python", 111, 0, 0, 0, 58, 26, 195
"c:\Users\Misah\OneDrive\Plocha\soubor\PV-Game\Server\Gameobjects\Item.py", "Python", 14, 0, 0, 0, 32, 4, 50
"c:\Users\Misah\OneDrive\Plocha\soubor\PV-Game\Server\Gameobjects\Map\Capital_city\Capital_city.py", "Python", 57, 0, 0, 0, 3, 10, 70
"c:\Users\Misah\OneDrive\Plocha\soubor\PV-Game\Server\Gameobjects\Map\Capital_city\Capital_city_tawern.py", "Python", 18, 0, 0, 0, 0, 4, 22
"c:\Users\Misah\OneDrive\Plocha\soubor\PV-Game\Server\Gameobjects\Map\Forest\Forest.py", "Python", 28, 0, 0, 0, 0, 3, 31
"c:\Users\Misah\OneDrive\Plocha\soubor\PV-Game\Server\Gameobjects\Map\Gem_town\Gem_town.py", "Python", 19, 0, 0, 0, 0, 2, 21
"c:\Users\Misah\OneDrive\Plocha\soubor\PV-Game\Server\Gameobjects\Map\Place.py", "Python", 145, 0, 0, 0, 0, 31, 176
"c:\Users\Misah\OneDrive\Plocha\soubor\PV-Game\Server\Gameobjects\Map\Route1\Route1.py", "Python", 21, 0, 0, 0, 0, 3, 24
"c:\Users\Misah\OneDrive\Plocha\soubor\PV-Game\Server\Gameobjects\Map\Route2\Route2.py", "Python", 20, 0, 0, 0, 0, 2, 22
"c:\Users\Misah\OneDrive\Plocha\soubor\PV-Game\Server\Gameobjects\NPC.py", "Python", 10, 0, 0, 0, 14, 2, 26
"c:\Users\Misah\OneDrive\Plocha\soubor\PV-Game\Server\Gameobjects\NPCs\Bartender.py", "Python", 84, 0, 0, 0, 0, 12, 96
"c:\Users\Misah\OneDrive\Plocha\soubor\PV-Game\Server\Gameobjects\Player.py", "Python", 103, 0, 0, 0, 95, 11, 209
"c:\Users\Misah\OneDrive\Plocha\soubor\PV-Game\Server\Interfaces\CMD_level.py", "Python", 29, 0, 0, 0, 26, 9, 64
"c:\Users\Misah\OneDrive\Plocha\soubor\PV-Game\Server\Interfaces\First_view.py", "Python", 87, 0, 0, 0, 57, 19, 163
"c:\Users\Misah\OneDrive\Plocha\soubor\PV-Game\Server\Interfaces\Inventory_level.py", "Python", 243, 0, 0, 0, 74, 28, 345
"c:\Users\Misah\OneDrive\Plocha\soubor\PV-Game\Server\Interfaces\Load_user.py", "Python", 31, 0, 0, 0, 11, 2, 44
"c:\Users\Misah\OneDrive\Plocha\soubor\PV-Game\Server\Interfaces\Profil\Profile.py", "Python", 116, 0, 0, 0, 52, 20, 188
"c:\Users\Misah\OneDrive\Plocha\soubor\PV-Game\Server\Interfaces\Register_view.py", "Python", 166, 0, 0, 0, 55, 27, 248
"c:\Users\Misah\OneDrive\Plocha\soubor\PV-Game\Server\NPC_battle\Battle_NPC.py", "Python", 6, 0, 0, 0, 0, 1, 7
"c:\Users\Misah\OneDrive\Plocha\soubor\PV-Game\Server\NPC_battle\NPC_battle.py", "Python", 53, 0, 0, 0, 16, 14, 83
"c:\Users\Misah\OneDrive\Plocha\soubor\PV-Game\Server\Others\Connection.py", "Python", 50, 0, 0, 0, 42, 9, 101
"c:\Users\Misah\OneDrive\Plocha\soubor\PV-Game\Server\Others\Crossing.py", "Python", 16, 0, 0, 0, 40, 5, 61
"c:\Users\Misah\OneDrive\Plocha\soubor\PV-Game\Server\Others\Help_methods.py", "Python", 8, 0, 0, 0, 27, 1, 36
"c:\Users\Misah\OneDrive\Plocha\soubor\PV-Game\Server\__init__.py", "Python", 63, 0, 0, 0, 12, 10, 85
"c:\Users\Misah\OneDrive\Plocha\soubor\PV-Game\Server\database.json", "JSON", 0, 0, 0, 5, 0, 0, 5
"c:\Users\Misah\OneDrive\Plocha\soubor\PV-Game\Server\lib\ICommand.py", "Python", 5, 0, 0, 0, 11, 1, 17
"c:\Users\Misah\OneDrive\Plocha\soubor\PV-Game\Server\server.json", "JSON", 0, 0, 0, 5, 0, 0, 5
"c:\Users\Misah\OneDrive\Plocha\soubor\PV-Game\mystic_jewels.session.sql", "SQL", 0, 1, 0, 0, 0, 0, 1
"Total", "-", 1842, 1, 79, 16, 1040, 322, 3300