"filename", "language", "SQL", "Python", "JSON", "Markdown", "comment", "blank", "total"
"c:\Users\Misah\OneDrive\Plocha\soubor\PV-Game\Client\__init__.py", "Python", 0, 119, 0, 0, 1, 14, 134
"c:\Users\Misah\OneDrive\Plocha\soubor\PV-Game\Client\konfig\client.json", "JSON", 0, 0, 6, 0, 0, 0, 6
"c:\Users\Misah\OneDrive\Plocha\soubor\PV-Game\Client\lib\hashing.py", "Python", 0, 5, 0, 0, 0, 1, 6
"c:\Users\Misah\OneDrive\Plocha\soubor\PV-Game\Client\new.py", "Python", 0, 80, 0, 0, 1, 7, 88
"c:\Users\Misah\OneDrive\Plocha\soubor\PV-Game\README.md", "Markdown", 0, 0, 0, 76, 0, 22, 98
"c:\Users\Misah\OneDrive\Plocha\soubor\PV-Game\Server\Database\Actions\Authentication.py", "Python", 0, 32, 0, 0, 0, 4, 36
"c:\Users\Misah\OneDrive\Plocha\soubor\PV-Game\Server\Database\Actions\Get_user_informations.py", "Python", 0, 24, 0, 0, 2, 3, 29
"c:\Users\Misah\OneDrive\Plocha\soubor\PV-Game\Server\Database\Actions\Inventory_db.py", "Python", 0, 48, 0, 0, 6, 7, 61
"c:\Users\Misah\OneDrive\Plocha\soubor\PV-Game\Server\Database\Actions\Load_player.py", "Python", 0, 24, 0, 0, 7, 3, 34
"c:\Users\Misah\OneDrive\Plocha\soubor\PV-Game\Server\Database\Actions\Quests.py", "Python", 0, 10, 0, 0, 4, 1, 15
"c:\Users\Misah\OneDrive\Plocha\soubor\PV-Game\Server\Database\Actions\Registration.py", "Python", 0, 35, 0, 0, 0, 5, 40
"c:\Users\Misah\OneDrive\Plocha\soubor\PV-Game\Server\Database\Actions\Set_quests.py", "Python", 0, 8, 0, 0, 1, 1, 10
"c:\Users\Misah\OneDrive\Plocha\soubor\PV-Game\Server\Database\Actions\Set_status.py", "Python", 0, 30, 0, 0, 0, 4, 34
"c:\Users\Misah\OneDrive\Plocha\soubor\PV-Game\Server\Database\Database.py", "Python", 0, 11, 0, 0, 0, 2, 13
"c:\Users\Misah\OneDrive\Plocha\soubor\PV-Game\Server\Enums\Next_message.py", "Python", 0, 6, 0, 0, 3, 2, 11
"c:\Users\Misah\OneDrive\Plocha\soubor\PV-Game\Server\Gameobjects\Building.py", "Python", 0, 111, 0, 0, 58, 26, 195
"c:\Users\Misah\OneDrive\Plocha\soubor\PV-Game\Server\Gameobjects\Item.py", "Python", 0, 14, 0, 0, 32, 4, 50
"c:\Users\Misah\OneDrive\Plocha\soubor\PV-Game\Server\Gameobjects\Map\Capital_city\Capital_city.py", "Python", 0, 57, 0, 0, 3, 10, 70
"c:\Users\Misah\OneDrive\Plocha\soubor\PV-Game\Server\Gameobjects\Map\Capital_city\Capital_city_tawern.py", "Python", 0, 18, 0, 0, 0, 4, 22
"c:\Users\Misah\OneDrive\Plocha\soubor\PV-Game\Server\Gameobjects\Map\Forest_of_life\Forest_of_life.py", "Python", 0, 25, 0, 0, 0, 3, 28
"c:\Users\Misah\OneDrive\Plocha\soubor\PV-Game\Server\Gameobjects\Map\Gem_town\Gem_town.py", "Python", 0, 19, 0, 0, 0, 2, 21
"c:\Users\Misah\OneDrive\Plocha\soubor\PV-Game\Server\Gameobjects\Map\Place.py", "Python", 0, 145, 0, 0, 0, 31, 176
"c:\Users\Misah\OneDrive\Plocha\soubor\PV-Game\Server\Gameobjects\Map\Route1\Route1.py", "Python", 0, 21, 0, 0, 0, 3, 24
"c:\Users\Misah\OneDrive\Plocha\soubor\PV-Game\Server\Gameobjects\Map\Route2\Route2.py", "Python", 0, 20, 0, 0, 0, 2, 22
"c:\Users\Misah\OneDrive\Plocha\soubor\PV-Game\Server\Gameobjects\NPC.py", "Python", 0, 10, 0, 0, 14, 2, 26
"c:\Users\Misah\OneDrive\Plocha\soubor\PV-Game\Server\Gameobjects\NPCs\Bartender.py", "Python", 0, 84, 0, 0, 0, 12, 96
"c:\Users\Misah\OneDrive\Plocha\soubor\PV-Game\Server\Gameobjects\Player.py", "Python", 0, 101, 0, 0, 95, 11, 207
"c:\Users\Misah\OneDrive\Plocha\soubor\PV-Game\Server\Interfaces\CMD_level.py", "Python", 0, 29, 0, 0, 26, 9, 64
"c:\Users\Misah\OneDrive\Plocha\soubor\PV-Game\Server\Interfaces\First_view.py", "Python", 0, 87, 0, 0, 57, 19, 163
"c:\Users\Misah\OneDrive\Plocha\soubor\PV-Game\Server\Interfaces\Inventory_level.py", "Python", 0, 232, 0, 0, 74, 29, 335
"c:\Users\Misah\OneDrive\Plocha\soubor\PV-Game\Server\Interfaces\Load_user.py", "Python", 0, 31, 0, 0, 11, 2, 44
"c:\Users\Misah\OneDrive\Plocha\soubor\PV-Game\Server\Interfaces\Profil\Profile.py", "Python", 0, 112, 0, 0, 52, 20, 184
"c:\Users\Misah\OneDrive\Plocha\soubor\PV-Game\Server\Interfaces\Register_view.py", "Python", 0, 166, 0, 0, 55, 27, 248
"c:\Users\Misah\OneDrive\Plocha\soubor\PV-Game\Server\Others\Connection.py", "Python", 0, 50, 0, 0, 42, 9, 101
"c:\Users\Misah\OneDrive\Plocha\soubor\PV-Game\Server\Others\Crossing.py", "Python", 0, 16, 0, 0, 40, 5, 61
"c:\Users\Misah\OneDrive\Plocha\soubor\PV-Game\Server\Others\Help_methods.py", "Python", 0, 8, 0, 0, 27, 1, 36
"c:\Users\Misah\OneDrive\Plocha\soubor\PV-Game\Server\__init__.py", "Python", 0, 63, 0, 0, 12, 10, 85
"c:\Users\Misah\OneDrive\Plocha\soubor\PV-Game\Server\database.json", "JSON", 0, 0, 5, 0, 0, 0, 5
"c:\Users\Misah\OneDrive\Plocha\soubor\PV-Game\Server\lib\ICommand.py", "Python", 0, 5, 0, 0, 11, 1, 17
"c:\Users\Misah\OneDrive\Plocha\soubor\PV-Game\mystic_jewels.session.sql", "SQL", 1, 0, 0, 0, 0, 0, 1
"Total", "-", 1, 1856, 11, 76, 634, 318, 2896